%%%%%%%%%%
%Po  G.%.%
%%%%%%%%%%
